#######
#     #
# # # #
# # # #
# ### #
#S#E  #
#######
