##########
#        #
#        #
#        #
#        #
#     E  #
#        #
#  S     #
#        #
#        #
#        #
#        #
##########
