#######
#     #
# # # #
# #E# #
# ### #
#S#   #
#######
